WWWWWWWWWWWWWWWWWWWWWWWWWWWWWWWWWWWWWWWW
WGGGGGGEGGDGREGGGGGRGRGGGGGGGEGGGGRGGGGW
WGRPRGGGGGGEGGGGGGGGGRRGGRGGGGEGGGGGEGGW
WGGGGGGGGGGEGGEGGGGGRGRGGRGGGGGGGGRGGGGW
WRGEEGGGGGGGGGRGGGGGGRGGRGGGGRGGGRGGGGGW
WRGRRGGGGGGGGGRRGGRGGGGGGGGRGGGGGGRGREGW
WGGGRGGRGGGGGGGGRGGGGGRGERGGGGGGGGRGRRGW
WBBBBBBBBBBBBBBBBBBBBBBBBBBBBBBGGGRGGRGW
WGEGGGRGGDGEGGRGRGGGGGGGGGGDGREGGGGGGRGW
WGGDGGGGGRGGGGGEGGGGGGGGREERGGDGGGGRGGGW
WGGGRGGRGRGGGGGGGGGGGGGGRRGRGGRGGGGGGGGW
WGEGGGGGRGGGGGGGGRREGGGGGGGRGGRGDGGGGEGW
WGRGGEGGRGEEGGGGGRGRDGGDGGGGRGGGRGGDGRGW
WGDRGGGGGGGGGGGGGGRRRGGRGGGGGGGGDGGGGGRW
WGGGGGGGGBBBBBBBBBBBBBBBBBBBBBBBBBBBBBBW
WEEGGGGGGGGGEGGGDGGGGRGGGGGRGGGRGGGGGGGW
WERGGGGGGGGGRRGGRGGGGGGGGRGGGGGGGRGREGGW
WGRGGRGGGGGGGGRGGGGGRGEEGGGGDGGGGRGRRGGW
WGGGGRDGGEGGGGGGGGRGGGGGGRGGDGGGGGGGRGGW
WGGGEGGEGRGGRGRRGGGGGGGGGRGRDGGGGGGGRGGW
WGDGGGGRGGGGGEGGGGGGGGGEGRGGRGGGGGRGGGRW
WWWWWWWWWWWWWWWWWWWWWWWWWWWWWWWWWWWWWWWW