WWWWWWWWWWWWWWWWWWWWWWWWWWWWWWWWWWWWWWWW
WBBBBBBBBBGGGGRGRGGRGGGGGGGGRGBBBBBBBBBW
WEEEEEEEEEGGGGGGGGGGGRGGGGRGGGEEEEEEEEEW
WEEDQEEEEEGGRGGGGGGGGGGRGGGRGGEEEEEQDEEW
WBBBBBBBBBGGRGGGGGGGGRGGGGGGRGBBBBBBBBBW
WEEEEEEEEEGGGGGGRGGGRGGGGGGGRGEEEEEEEEEW
WEEDQEEEEEGGGGRGGGGGGRGRRGGGGGEEEEEQDEEW
WBBBBBBBBBGRRGGGGGGGGRGRRGGGGGBBBBBBBBBW
WEEEEEEEEEGGGGRGRGGGGRGGRGGGGGEEEEEEEEEW
WEEDQEEEEEGGGGRGRGGGGRGGRGGRGGEEEEEQDEEW
WBBBBBBBBBGRRGRGGRGGGGRGGGRGGGBBBBBBBBBW
WEEEEEEEEEGRRGRGGRGGGGGGGGGGGGEEEEEEEEEW
WEEDQEEEEEGGGGRGGRGGGGGGGGRGGGEEEEEQDEEW
WBBBBBBBBBGGGGGRGGGRGGGGRGGRGGBBBBBBBBBW
WGGGGRGRGGRGGGGGGGGRGGGGGRGGGGGGGGGGGGRW
WGGGGGGRGGGGRGGGGRGGRGRGGGRGGRGGGGGGGGGW
WGGRGGGGRGGGGGRGGGRGGGGGGGRGGRGGGGGGGGGW
WGGRGGGGGGGGRGGGGGGRGRRGGGGGGGGGRGGGGGGW
WRGPGGGRGGGGGGGGGGGRGRRGGGGGGGGGRRGGRGPW
WGGGGRGGGGGGRGRRGGGGGGRGGGGGGGGRGGRGGGGW
WRRGGGGGGGGGRGRRGGGGGGGGGRGGRGRGRGGRGGGW
WWWWWWWWWWWWWWWWWWWWWWWWWWWWWWWWWWWWWWWW