WWWWWWWWWWWWWWWWWWWWWWWWWWWWWWWWWWWWWWWW
WPGGGGGRGGGGGGGGGGGGGGGGGGGGRGGGGGGGGRGW
WGGGGGRGGGGGGGGGGGGGGRGGGGGGGGGGGGGGGGGW
WGGGGGGGGRGGRGGGGGGGGGGGGGGGGGGGGGGGGGGW
WRGGGGGGGGGGGGGGGGGGGGGGGGGGGGGGGGGGGGGW
WGGGGGGGGGGGGGGGGGGGRGGGGGGGGGGGGGGGGGGW
WGRGGGGGGGGGGGGGGGGGGGGGRGGGGGGGGGRGGGGW
WGGRGGGGGRGGGGGGGGGGGRGGRGGGGGGGGGGGGGRW
WGGGGGGRGGGGGGRGGGGGGGGGGGGGGGGGGGGGRGGW
WGGGGGGGEEQEGGRGEEQEGGGGEEQEGGGGEEQEGGGW
WGGGGGGGEEEEGGRGEEEEGGGGEEEEGGGGEEEERGGW
WGGGGGGGGGGGGGGGGGGGGGGGGGGGGGGGGGGGGGGW
WGGGRGGGGGGGGGGGGGGGGGGGGGGGGGGGGGGRGGGW
WGGGRGGGGGRGGGGGGGGGGGGGGGGGGGGGGGGGGGGW
WGGGGGGRGGGGGGGGGGGRGGGGGGGGGGGGGGGGGGRW
WGGGGGGGGGGGRGGGGGGGRGGGGGGGGGGGGGGGGGGW
WGGRGGGGGGGGGGGGGGRGGGGGGGGGGGGGGGGGGGGW
WGGGGGGGGGGGGGGGGGGGGGRGGGGGGGGGRGGGGGGW
WGGGGGGGGGGGGGGGGGGGGGGGGGGGGGGGGRGGRGGW
WGGGGRGGGGGGRGRRGGGGGGGGGGGGGGGGGGRGGGGW
WGGGGGGGGGGGRGRRGGGGGGGGGRGGRGRGGGGGGGGW
WWWWWWWWWWWWWWWWWWWWWWWWWWWWWWWWWWWWWWWW