WWWWWWWWWWWWWWWWWWWWWWWWWWWWWWWWWWWWWWWW
WRGBBGBRRGBGGGRBRGGRGGGGBGGGRGGGGGRBGDGW
WGGPBGDGRGBGGGBBBGGBGRGGGGRGGRGRGGGBGBRW
WGGGGBGGRDGGRGGGGBGGGGGRGBBRGGGGGGGBGBBW
WDGBGGBRBRGGRGGGGBGGGRGGGGGGRGRRGGGGGGBW
WRGBGGGBGGRGBBGGRGBBDGGGGGGGRGRRGGGGGGBW
WRRGGRGGGGBGGGRGGGGGGRGRRGGGGGGRGGDBBGGW
WGGRGBBGGRGRRGGGBGGGGRGRRGGGGGGBGGRGBGRW
WGGBGGGDGGGGGGDGRGGBBRGGRGBGBRGGBRGGDGRW
WRGRGGGGBGBBGGDGRGGBBRGGRGGDGBGGGBGGRGBW
WGRGBBGGGGGRRBRGGDGBGBRGGBRGGGBRGGDGRGGW
WBGBBGGGGGGRRBRGGRGBGBBGGGBGGRGBBGGRGBBW
WGBGRGRGBGGGBBRGGRGGGGBGGGRGGGGGBBGRGBBW
WGBGRGRGBGDGBGBRGGBRGGGGRGGRGRRGGGGBGGGW
WBGGBRBRGGRGGGGBGGGDGGGBGRBGGGGGGBGBBGDW
WBGGGBBRGGBGDGGGBRGGRGRGGGRGBRGGGGGGBGGW
WBGDGGGGRGBBGGRGBBRGGGGGGGRGBRGGGGGGBGGW
WGGRGGGGBGGGRGGGGGGRGRRGGGGGGBGGRGBGGGBW
WRGBBGGRGBBGGGBGGGGRGRRGGGGGGBGGRDGGRGGW
WBGGGRGGGGGGRGRDGGGGGGRGGGBBGGBRGGDGBGGW
WRRGGGBGGGGGRGRDGGGGGGBGGRGBDGDGRBGRGGGW
WWWWWWWWWWWWWWWWWWWWWWWWWWWWWWWWWWWWWWWW