WWWWWWWWWWWWWWWWWWWWWWWWWWWWWWWWWWWWWWWW
WGEGGEGRRGGGGGEGGRGEPGGGGERRERGGRGEGEEGW
WEGGRGEGGEGEEGGGGEGRGRGEGGGEERGGRGDGGEGW
WRGGGGGEEGQGEEGGGEGRGRGEGGGEBBBBBBBBBBBW
WGRGDGGGEGEEGGGGGGEGGRRGGRGGGGEGEGGGEGEW
WBBBBBBBBBBBBGRGEGGEEERGGEGGGGEGGGRGGGGW
WRGERGGGGGGEGGRGEGGGEGGRGEEGGRGEEQGGGGGW
WRGERGGGGGGEGGERGGRGGGGEGGGRGGGGGGRGRRGW
WGGGEGGREEGGGEGGRGEEGGRGEEGGGEGGGGRGRRGW
WGGGEGGRGEGRGGGGEGGGQGGGGGGRGRGGEERGGRGW
WEEGGERGGGGEGGRGRGGGGEGEEGGGGGGGEEDGGEGW
WGEGGGEGGEGEEGGEGEEGGGGGRRERGGRGEGERGGEW
WGGEDGGRGRGGGGEGEEGGGGGGREERGGRGEGEEGGGW
WGRGEEGGRGEEGGGEGRGRGEGGGEERGGEGGGGEGGGW
WGGGGEEGRGEEGGGEGRGRGEGRGEGERGGERGGGGEGW
WGEEGGGGEGGGGEEGGERERGGRGGGGEGGGRGGGEGRW
WGGGGGEGEEGRRGEGGGEERGGEGRGGGERGGRGRGGGW
WERGGGGGGEGGRGEGRGGGGEGEEGGRGEERGGGGGGGW
WERGGGGGGEGGERGGRGGGGEGGGRGGGGGGRGRRGGGW
WGEGGRGEGGGEGGRGEEGEEGEEGGGEGGGGRGRRGGGW
WGEGDRQGGRGGGGEGGGRGGGGGGRGRQGGGGGDRGGGW
WWWWWWWWWWWWWWWWWWWWWWWWWWWWWWWWWWWWWWWW