WWWWWWWWWWWWWWWWWWWWWWWWWWWWWWWWWWWWWWWW
WGRGGRGGBGRGGGDGBGGGEGRGBRGGGGGGBGGRRGGW
WGGGGGGGBGGGGGGRBRRGEGGGBEGGDGGGBGGGGRGW
WEEEEEEEEEEEEEEEEEEEEEEEEEEEEEEEEEEEEEEW
WDGGGGGGBGRGGGGRBGRGEGGEBGGRGGDGBGGRGRGW
WGGGGGGGBGRGGGGRBGRGERGGBGGGGGRGBGGGEGGW
WBBBBBBBBBBBBBBBBBBBEBBBBBBBBBBBBBBBBBBW
WGGGGRRGBGGRGGGGBGGGEGGRBGGGGRGGBGGGGGRW
WGGGGGGGBGGEGGGGBGGGEGGGBGGGGRGEBGGGGGRW
WEEEEEEEEEEEEEEEEEEEEEEEEEEEEEEEEEEEEEEW
WRGGRGGGBGGGGRGGBGGREGGGBGGGGGGDBRGGGGGW
WRGGGGRGBGGRGGRGBGGGEGERBGGGGGGGBRGGGRGW
WGRGGGGGBGGGRGGGBGGGEGERBGGGGGGGBERGGRGW
WBBBBBBBBBBBBBBBBBBBEBBBBBBBBBBBBBBBBBBW
WRGEEQGGBGGGGRGRBGGGEGGGBGRDGGRGBGGGGGGW
WGGGGGRGBRGGGGGGBGGDEGGGBEGGRGGGBGRGRRGW
WEEEEEEEEEEEEEEEEEEEEEEEEEEEEEEEEEEEEEEW
WDGGEGRGBRGGGGRGBGRGEGGRBGRGRGGGBGGGGGGW
WGGGGGRGBRGGDGGGBGGGERGGBGGRGGGGBGGGRREW
WGDGGGREBGGRGGGGBGPDERGGBGEGGGGGBGGGRREW
WGRGGGGRBGGEGGRGBGWGEGGGBGGGGRGRBGGGGEGW
WWWWWWWWWWWWWWWWWWWWWWWWWWWWWWWWWWWWWWWW